Surely the reed bank counts as a wild place. While it gives you so much, you've never tended it, not really, not like you do with your garden. And you've certainly seen birds there. It's something like the forest, then, but much safer to search without attracting attention. So here you are.

The Warbler's Nest
A fairy tale by Jason McIntosh
Release 22 / Serial number 150312 / Inform 7 build 6L38 (I6/v6.33 lib 6/12N) SD
For more information about this game, please type ABOUT.

Among the reeds
The familiar reed bank behind your cottage surrounds you, filling the damp space between your home and the river to the south.

>help
 > About this Game
   Instructions for Play
   Contacting the Author
   Game Homepage
   Hints and Walkthrough

>q
Among the reeds
The familiar reed bank behind your cottage surrounds you, filling the damp space between your home and the river to the south.

* * *

>n
As you start back towards your home, movement among the reeds catches your eye: A little reed-bird flies in from the riverbank and vanishes into the green, near a tall stalk with an early flower.

"Eggshells," he said. "You should find two, empty but mostly whole."

"Well," you said, "That's easy enough. Hod down the road has a hen, and --"

"No," he interrupted with a shake of his grey head. "You've got to find them in the wild places in between, where nobody lives. Not even them. Go out in the hour just before sundown, when they're not quite awake yet..."

Remembering, you look at the sky, reflexively.

Today the sky is a uniform middling gray. Overcast.

>x flower
(the tall stalk)
Carefully approaching the tall stalk, you discover the hiding place of the reed bird's nest.

The reed-bird goes about the business of feeding its young.

>z
Time passes.

The reed-bird goes about the business of feeding its young.

>z
Time passes.

The reed-bird goes about the business of feeding its young.

The reed-bird darts away again, perhaps looking for more food for its enormous chick.

>l
Among the reeds
The familiar reed bank behind your cottage surrounds you, filling the damp space between your home and the river to the south.

One particularly tall stalk, topped with an early flower, marks the location of the reed bird's nest.

The chick, now fed, resettles itself atop the nest, preening a bit. As it does so, loose feathers and other bits of refuse drift down to join a pile on the ground beneath it.

>l
Among the reeds
The familiar reed bank behind your cottage surrounds you, filling the damp space between your home and the river to the south.

Under the nest is a small mound of feathers, straw, droppings, and other matter apparently dropped from the reed-bird's nest and its occupant.

One particularly tall stalk, topped with an early flower, marks the location of the reed bird's nest.

>l
Among the reeds
The familiar reed bank behind your cottage surrounds you, filling the damp space between your home and the river to the south.

Under the nest is a small mound of feathers, straw, droppings, and other matter apparently dropped from the reed-bird's nest and its occupant.

One particularly tall stalk, topped with an early flower, marks the location of the reed bird's nest.

>x ground
Careful not to disturb the nest, you poke through the ground around it. Your efforts are rewarded: Not far away, among a small pile of the birdish refuse on the ground, lies a small egg.

>i
You are carrying nothing.

* * *

>search reeds
The bird dropped down into the reeds some distance away, near one particularly tall stalk, topped with a flower that's come in early.

>x stalk
Carefully approaching the tall stalk, you discover the hiding place of the reed bird's nest.

The reed-bird goes about the business of feeding its young.

>z
Time passes.

The reed-bird goes about the business of feeding its young.

* * *

>z
Time passes.

The reed-bird goes about the business of feeding its young.

The reed-bird darts away again, perhaps looking for more food for its enormous chick.

>z
Time passes.

The chick, now fed, resettles itself atop the nest, preening a bit. As it does so, loose feathers and other bits of refuse drift down to join a pile on the ground beneath it.

>get feathers
The pile underneath the nest is made of stuff you've no reason to carry around. But you do see a small egg lying amid the offal. You pick that up.

Holding it, you now see that the egg's surface is webbed with cracks, as if it had been dropped.

>get feathers
There's nothing else in that pile worth carrying around.

* * *

>z
Time passes.

The chick, now fed, resettles itself atop the nest, preening a bit. As it does so, loose feathers and other bits of refuse drift down to join a pile on the ground beneath it.

>x feathers
Collected under the nest is a small pile of bird-leavings.

You spy a small egg lying among the offal.

>get egg
Holding it, you now see that the egg's surface is webbed with cracks, as if it had been dropped.

>get feathers
There's nothing else in that pile worth carrying around.

* * *

>get egg
Holding it, you now see that the egg's surface is webbed with cracks, as if it had been dropped.

>x cracks
A small spotted egg, its surface webbed with cracks.

>x egg
A small spotted egg, its surface webbed with cracks.

>i
You are carrying:
  a small cracked egg (closed)

>x cracks
A small spotted egg, its surface webbed with cracks.

* * *

>x egg
A small spotted egg, its surface webbed with cracks.

>open egg
Peeling away the topmost fragments from the egg's shell reveals the tiny body of a dead chick, unborn, encased in a veined and rotting yolk.

You manage to keep your grip on the shell, just the same.

>x egg
A small spotted eggshell, its surface webbed with cracks.

In the cracked eggshell is a dead chick.

* * *

>x stalk
Carefully approaching the tall stalk, you discover the hiding place of the reed bird's nest.

The reed-bird goes about the business of feeding its young.

>x bird
(the reed-bird)
A small reddish bird. It's perched on a stem beside its nest, feeding its young.

The reed-bird goes about the business of feeding its young.

>x chick
This bird has the plumage and shape of one that's hatched very recently. Oddly, though, it looks like a larger animal than the reed-bird feeding it. It's so large that it doesn't seem to quite fit in the nest, instead squatting on top of it.

The reed-bird goes about the business of feeding its young.

The reed-bird darts away again, perhaps looking for more food for its enormous chick.

>x young
This bird has the plumage and shape of one that's hatched very recently. Oddly, though, it looks like a larger animal than you remember its parent being. It's so large that it doesn't seem to quite fit in the nest, instead squatting on top of it.

The chick, now fed, resettles itself atop the nest, preening a bit. As it does so, loose feathers and other bits of refuse drift down to join a pile on the ground beneath it.

>get bird
You'd rather not disturb this nest. You've been living fine all these years considering the reed-bird a thatcher's friend, keeping the reeds free of worse nuisances.

>l
Among the reeds
The familiar reed bank behind your cottage surrounds you, filling the damp space between your home and the river to the south.

Under the nest is a small mound of feathers, straw, droppings, and other matter apparently dropped from the reed-bird's nest and its occupant.

One particularly tall stalk, topped with an early flower, marks the location of the reed bird's nest.

>get nest
You'd rather not disturb this nest. You've been living fine all these years considering the reed-bird a thatcher's friend, keeping the reeds free of worse nuisances.

>search nest
No eggs here. That big chick would leave them no room, anyway.

>look in nest
No eggs here. That big chick would leave them no room, anyway.

>x trash
You can't see any such thing.

>x mound
Collected under the nest is a small pile of bird-leavings.

You spy a small egg lying among the offal.

>get egg
Holding it, you now see that the egg's surface is webbed with cracks, as if it had been dropped.

>n
Outside the cottage
A space in front of your home, long ago cleared from the reed bank to the south. You can see the road from here, and of course the forest beyond it.

Your garden lies here, good earth and green, a row of stones marking it off.

The doorway to your cottage is to the east. You could also walk around the cottage, to the northeast or the southeast, towards the little clearing you know is there.

Something is wrong.

>go road
You could start down the road now, but it would be getting on dark by the time you got anywhere. All that's in between is forest, and you've no business there.

You realize what's wrong now. It's quiet.

You were so involved among the reeds just now that you hadn't paid it mind, but: the cottage is silent.

>go behind cottage
I only understood you as far as wanting to go northeast.

>ne
You take a few steps around the side of the cottage, but stop short when a soft sound breaks the heavy silence. A scrabbling, snuffling sort of sound, coming from behind the cottage.

It sounds like something alive.

The tailor gestured to some mushrooms growing near your garden. "Fairy ring," he said. "These grow where they gather and dance, in the forest, and also where they mean to meddle, in the places we live." Looking again, yes, the mushrooms did seem to have a sort of circular pattern to them.

"You musn't let them grow so near your home like this, first of all," he said, "as it makes them bolder."

"All right," you said, unsure why his voice seemed so heavy with concern. "I can just treat them like the weeds in the garden, then."

"Yes..." he said, and paused before looking at you again.

"There's something else."

You remain in the garden, and in the not-quite-silence.

>l
Outside the cottage
A space in front of your home, long ago cleared from the reed bank to the south. You can see the road from here, and of course the forest beyond it.

Your garden lies here, good earth and green, a row of stones marking it off.

The doorway to your cottage is to the east. You could also walk around the cottage, to the northeast or the southeast, towards the little clearing you know is there.

Silence, especially strange for this time of day, sits heavily in the clearing.

>ne
Hearing that scratching, snuffling sound again, you hesitate. All you're carrying is this eggshell, and you'd feel bolder if you held something a bit more solid. Something that would do in a pinch, if it came to it.

>ne
Hearing that scratching, snuffling sound again, you hesitate. All you're carrying is this eggshell, and you'd feel bolder if you held something a bit more solid. Something that would do in a pinch, if it came to it.

>l
Outside the cottage
A space in front of your home, long ago cleared from the reed bank to the south. You can see the road from here, and of course the forest beyond it.

Your garden lies here, good earth and green, a row of stones marking it off.

The doorway to your cottage is to the east. You could also walk around the cottage, to the northeast or the southeast, towards the little clearing you know is there.

Silence, especially strange for this time of day, sits heavily in the clearing.

>x garden
This is where you tend the vegetables for your potage. Wooden stakes help keep the different plants in line. An uneven line of small stones mark off the little garden's borders.

>get a stake
You pull one of the stakes out of the earth, and wrap your hand tightly around one end, holding like a club.

>get stone
You toss the stake aside.

You pull a small, round rock from the earth. Amidst worries of eggshells, you find comfort in its solid heft.

Taken.

* * *

>x stalk
Carefully approaching the tall stalk, you discover the hiding place of the reed bird's nest.

The reed-bird goes about the business of feeding its young.

>look under nest
Careful not to disturb the nest, you poke through the ground around it. Your efforts are rewarded: Not far away, among a small pile of the birdish refuse on the ground, lies a small egg.

The reed-bird goes about the business of feeding its young.

>n
Outside the cottage
A space in front of your home, long ago cleared from the reed bank to the south. You can see the road from here, and of course the forest beyond it.

Your garden lies here, good earth and green, a row of stones marking it off.

The doorway to your cottage is to the east. You could also walk around the cottage, to the northeast or the southeast, towards the little clearing you know is there.

Something is wrong.

>get rock
You pull a small, round rock from the earth. Amidst worries of eggshells, you find comfort in its solid heft.

Taken.

You realize what's wrong now. It's quiet.

You were so involved among the reeds just now that you hadn't paid it mind, but: the cottage is silent.

>ne
You take a few steps around the side of the cottage, but stop short when a soft sound breaks the heavy silence. A scrabbling, snuffling sort of sound, coming from behind the cottage.

It sounds like something alive.

The tailor gestured to some mushrooms growing near your garden. "Fairy ring," he said. "These grow where they gather and dance, in the forest, and also where they mean to meddle, in the places we live." Looking again, yes, the mushrooms did seem to have a sort of circular pattern to them.

"You musn't let them grow so near your home like this, first of all," he said, "as it makes them bolder."

"All right," you said, unsure why his voice seemed so heavy with concern. "I can just treat them like the weeds in the garden, then."

"Yes..." he said, and paused before looking at you again.

"There's something else."

You remain in the garden, and in the not-quite-silence.

>ne
Behind your cottage
Another small clearing behind your cottage. You do not come here very often, or anyway not lately.

You could wander back into the reeds to the south, or return to your garden by walking northwest or southwest around your home. The road lies to the north, where it runs east, vanishing into the dark wood.

The forest also looms to the east of where you now stand. An old fallen log reaches out of it, into the clearing.

Two standing stones mark the earth here, along the rear wall of the cottage. One, waist-high, stands larger than the other.

You hear that snuffling noise again, from somewhere very near.

>look behind log
Tightening your grip on the rock, you peer behind the log, so that you can see the whole of the mushroom ring, and whatever else might sit inside it.

You see it. A skinny little man, wearing a... a fur coat, and a spotted cap? It's lying down, right in the center of the fairy ring, damn it all, and its tail twitches as it... oh.

You let go the breath you hadn't realized you were holding. No, it's not a little man. Though it is another sort of forest creature, true enough, and maybe no less wicked, in its way.

And that "cap" does catch your attention...

>kill stoat
You throw the rock at the little animal. It lands wide, and the creature wastes no time in scurrying back into the forest, leaving its meal behind.

>get egg
You pick up the eggshell from where the little animal left it.

>sw
Outside the cottage
A space in front of your home, long ago cleared from the reed bank to the south. You can see the road from here, and of course the forest beyond it.

Your garden lies here, good earth and green, a row of stones marking it off.

The doorway to your cottage is to the east. You could also walk around the cottage, to the northeast or the southeast, towards the little clearing you know is there.

Silence, especially strange for this time of day, sits heavily in the clearing.

>s
Among the reeds
The familiar reed bank behind your cottage surrounds you, filling the damp space between your home and the river to the south.

A small, spotted egg lies on the ground underneath the nest.

Under the nest is a small mound of feathers, straw, droppings, and other matter apparently dropped from the reed-bird's nest and its occupant.

One particularly tall stalk, topped with an early flower, marks the location of the reed bird's nest.

The chick, now fed, resettles itself atop the nest, preening a bit. As it does so, loose feathers and other bits of refuse drift down to join a pile on the ground beneath it.

>n
Outside the cottage
A space in front of your home, long ago cleared from the reed bank to the south. You can see the road from here, and of course the forest beyond it.

Your garden lies here, good earth and green, a row of stones marking it off.

The doorway to your cottage is to the east. You could also walk around the cottage, to the northeast or the southeast, towards the little clearing you know is there.

Silence, especially strange for this time of day, sits heavily in the clearing.

>x silence
You know from hard experience that the cottage oughtn't be silent at this time of day. But, it's so.

>l
Outside the cottage
A space in front of your home, long ago cleared from the reed bank to the south. You can see the road from here, and of course the forest beyond it.

Your garden lies here, good earth and green, a row of stones marking it off.

The doorway to your cottage is to the east. You could also walk around the cottage, to the northeast or the southeast, towards the little clearing you know is there.

Silence, especially strange for this time of day, sits heavily in the clearing.

>s
Among the reeds
The familiar reed bank behind your cottage surrounds you, filling the damp space between your home and the river to the south.

Under the nest is a small mound of feathers, straw, droppings, and other matter apparently dropped from the reed-bird's nest and its occupant.

A small, spotted egg lies on the ground underneath the nest.

One particularly tall stalk, topped with an early flower, marks the location of the reed bird's nest.

>get egg
(the small spotted egg)
Holding it, you now see that the egg's surface is webbed with cracks, as if it had been dropped.

"Once you've found those eggshells," the tailor continued, "what you do is -- this sounds strange, but that's the whole point, see -- you need to fill them up with water. Then you carry them, one in each hand, like they're the heaviest buckets, you carry them right back into your cottage, and you show them to him."

He paused then, but you only nodded, unsure what to say to all this.

* * *

>x fallen log
This ancient tree has lain on this spot since you first came here, and surely a lifetime or more before that. 

Though dead, it's not a decayed thing. Rather, it's part of the living forest, and maybe the spot at which its reach comes closest to your cottage. It makes you think more of the little finger of a sleeping giant, whose body lies vast in the shadows of the wood beyond.

Near one end, a half-circle of milk-colored mushrooms bulge from the earth.

* * *

>look under nest
Careful not to disturb the nest, you poke through the ground around it. Your efforts are rewarded: Not far away, among a small pile of the birdish refuse on the ground, lies a small egg.

The reed-bird goes about the business of feeding its young.

>get egg
Holding it, you now see that the egg's surface is webbed with cracks, as if it had been dropped.

The reed-bird goes about the business of feeding its young.

The reed-bird darts away again, perhaps looking for more food for its enormous chick.

>s
Beach
A small bulge of sandy beach, providing a place to stand comfortably and access the river water clear of the reeds. The river to the south curves gently around it.

The river flows here, as it always has, clear and cool.

>open egg
Peeling away the topmost fragments from the egg's shell reveals the tiny body of a dead chick, unborn, encased in a veined and rotting yolk.

You manage to keep your grip on the shell, just the same.

>pour egg
Grimacing, you upend the egg. The dead thing and its murky goo tumble out wetly. You turn your head away, not caring to see what becomes of it.

The shell is empty now.

>fill egg with water
You dip the eggshell into the river, then stand back up again, careful not to spill any.

>n
The wind shifts the reeds, hiding the bird's nest from sight. You still see the tall stalk marking where you found it earlier, not far away.

Among the reeds
The familiar reed bank behind your cottage surrounds you, filling the damp space between your home and the river to the south.

One particularly tall stalk, topped with an early flower, marks the location of the reed bird's nest.

>n
Outside the cottage
A space in front of your home, long ago cleared from the reed bank to the south. You can see the road from here, and of course the forest beyond it.

Your garden lies here, good earth and green, a row of stones marking it off.

The doorway to your cottage is to the east. You could also walk around the cottage, to the northeast or the southeast, towards the little clearing you know is there.

Something is wrong.

>e
You look at your cottage, but find yourself unable to go within. Something is wrong, and you stand, listening...

You realize what's wrong now. It's quiet.

You were so involved among the reeds just now that you hadn't paid it mind, but: the cottage is silent.

>e
The silence is strange, all right. But you haven't been out of the house that long, and don't plan on being out that much longer.

You chose to take up this task, and you'd best see it through... before facing what's in there.

"Eggshells," he said. "You should find two, empty but mostly whole..."

>e
The silence is strange, all right. But you haven't been out of the house that long, and don't plan on being out that much longer.

You chose to take up this task, and you'd best see it through... before facing what's in there.

"Eggshells," he said. "You should find two, empty but mostly whole..."

>ne
You take a few steps around the side of the cottage, but stop short when a soft sound breaks the heavy silence. A scrabbling, snuffling sort of sound, coming from behind the cottage.

It sounds like something alive.

The tailor gestured to some mushrooms growing near your garden. "Fairy ring," he said. "These grow where they gather and dance, in the forest, and also where they mean to meddle, in the places we live." Looking again, yes, the mushrooms did seem to have a sort of circular pattern to them.

"You musn't let them grow so near your home like this, first of all," he said, "as it makes them bolder."

"All right," you said, unsure why his voice seemed so heavy with concern. "I can just treat them like the weeds in the garden, then."

"Yes..." he said, and paused before looking at you again.

"There's something else."

You remain in the garden, and in the not-quite-silence.

>e
The silence is strange, all right. But you haven't been out of the house that long, and don't plan on being out that much longer.

You chose to take up this task, and you'd best see it through... before facing what's in there.

"Eggshells," he said. "You should find two, empty but mostly whole..."

That soft scratching sound from behind the cottage comes again, interrupting your thoughts.

>e
The silence is strange, all right. But you haven't been out of the house that long, and don't plan on being out that much longer.

You chose to take up this task, and you'd best see it through... before facing what's in there.

"Eggshells," he said. "You should find two, empty but mostly whole..."

That soft scratching sound from behind the cottage comes again, interrupting your thoughts.

* * *

>n
Outside the cottage
A space in front of your home, long ago cleared from the reed bank to the south. You can see the road from here, and of course the forest beyond it.

Your garden lies here, good earth and green, a row of stones marking it off.

The doorway to your cottage is to the east. You could also walk around the cottage, to the northeast or the southeast, towards the little clearing you know is there.

Something is wrong.

>listen
You realize what's wrong now. It's quiet.

You were so involved among the reeds just now that you hadn't paid it mind, but: the cottage is silent.

But: You do hear a soft sound, unfamiliar, coming from the space behind your cottage.

Something alive.

The tailor gestured to some mushrooms growing near your garden. "Fairy ring," he said. "These grow where they gather and dance, in the forest, and also where they mean to meddle, in the places we live." Looking again, yes, the mushrooms did seem to have a sort of circular pattern to them.

"You musn't let them grow so near your home like this, first of all," he said, "as it makes them bolder."

"All right," you said, unsure why his voice seemed so heavy with concern. "I can just treat them like the weeds in the garden, then."

"Yes..." he said, and paused before looking at you again.

"There's something else."

* * *

>n
Outside the cottage
A space in front of your home, long ago cleared from the reed bank to the south. You can see the road from here, and of course the forest beyond it.

Your garden lies here, good earth and green, a row of stones marking it off.

The doorway to your cottage is to the east. You could also walk around the cottage, to the northeast or the southeast, towards the little clearing you know is there.

Something is wrong.

>get stake
You pull one of the stakes out of the earth, and wrap your hand tightly around one end, holding like a club.

You realize what's wrong now. It's quiet.

You were so involved among the reeds just now that you hadn't paid it mind, but: the cottage is silent.

>listen
You know from hard experience that the cottage oughtn't be silent at this time of day. But, it's so.

But: You do hear a soft sound, unfamiliar, coming from the space behind your cottage.

Something alive.

The tailor gestured to some mushrooms growing near your garden. "Fairy ring," he said. "These grow where they gather and dance, in the forest, and also where they mean to meddle, in the places we live." Looking again, yes, the mushrooms did seem to have a sort of circular pattern to them.

"You musn't let them grow so near your home like this, first of all," he said, "as it makes them bolder."

"All right," you said, unsure why his voice seemed so heavy with concern. "I can just treat them like the weeds in the garden, then."

"Yes..." he said, and paused before looking at you again.

"There's something else."

>g
The silence is not complete. Straining to hear, you can make out a scrabbling, a snuffling. Very soft, but in the stillness around your home, it stands out.

The sound is coming from the place behind the cottage.

>ne
Behind your cottage
Another small clearing behind your cottage. You do not come here very often, or anyway not lately.

You could wander back into the reeds to the south, or return to your garden by walking northwest or southwest around your home. The road lies to the north, where it runs east, vanishing into the dark wood.

The forest also looms to the east of where you now stand. An old fallen log reaches out of it, into the clearing.

Two standing stones mark the earth here, along the rear wall of the cottage. One, waist-high, stands larger than the other.

>sw
Outside the cottage
A space in front of your home, long ago cleared from the reed bank to the south. You can see the road from here, and of course the forest beyond it.

Your garden lies here, good earth and green, a row of stones marking it off.

The doorway to your cottage is to the east. You could also walk around the cottage, to the northeast or the southeast, towards the little clearing you know is there.

Silence, especially strange for this time of day, sits heavily in the clearing.

>ne
Behind your cottage
Another small clearing behind your cottage. You do not come here very often, or anyway not lately.

You could wander back into the reeds to the south, or return to your garden by walking northwest or southwest around your home. The road lies to the north, where it runs east, vanishing into the dark wood.

The forest also looms to the east of where you now stand. An old fallen log reaches out of it, into the clearing.

Two standing stones mark the earth here, along the rear wall of the cottage. One, waist-high, stands larger than the other.

>listen
You hold your breath...

The sound seems to be coming from behind the log.

>look behind
What do you want to look behind?

>log
Tightening your grip on the stake, you peer behind the log, so that you can see the whole of the mushroom ring, and whatever else might sit inside it.

You see it. A skinny little man, wearing a... a fur coat, and a spotted cap? It's lying down, right in the center of the fairy ring, damn it all, and its tail twitches as it... oh.

You let go the breath you hadn't realized you were holding. No, it's not a little man. Though it is another sort of forest creature, true enough, and maybe no less wicked, in its way.

And that "cap" does catch your attention...

>sw
Outside the cottage
A space in front of your home, long ago cleared from the reed bank to the south. You can see the road from here, and of course the forest beyond it.

Your garden lies here, good earth and green, a row of stones marking it off.

The doorway to your cottage is to the east. You could also walk around the cottage, to the northeast or the southeast, towards the little clearing you know is there.

Silence, especially strange for this time of day, sits heavily in the clearing.

>ne
Behind your cottage
Another small clearing behind your cottage. You do not come here very often, or anyway not lately.

You could wander back into the reeds to the south, or return to your garden by walking northwest or southwest around your home. The road lies to the north, where it runs east, vanishing into the dark wood.

The forest also looms to the east of where you now stand. An old fallen log reaches out of it, into the clearing.

Two standing stones mark the earth here, along the rear wall of the cottage. One, waist-high, stands larger than the other.

Behind the trunk, a stoat dines noisily on a stolen bird's egg, unaware of your presence.

* * *

>ne
Behind your cottage
Another small clearing behind your cottage. You do not come here very often, or anyway not lately.

You could wander back into the reeds to the south, or return to your garden by walking northwest or southwest around your home. The road lies to the north, where it runs east, vanishing into the dark wood.

The forest also looms to the east of where you now stand. An old fallen log reaches out of it, into the clearing.

Two standing stones mark the earth here, along the rear wall of the cottage. One, waist-high, stands larger than the other.

>look behind log
Tightening your grip on the stake, you peer behind the log, so that you can see the whole of the mushroom ring, and whatever else might sit inside it.

You see it. A skinny little man, wearing a... a fur coat, and a spotted cap? It's lying down, right in the center of the fairy ring, damn it all, and its tail twitches as it... oh.

You let go the breath you hadn't realized you were holding. No, it's not a little man. Though it is another sort of forest creature, true enough, and maybe no less wicked, in its way.

And that "cap" does catch your attention...

>sw
Outside the cottage
A space in front of your home, long ago cleared from the reed bank to the south. You can see the road from here, and of course the forest beyond it.

Your garden lies here, good earth and green, a row of stones marking it off.

The doorway to your cottage is to the east. You could also walk around the cottage, to the northeast or the southeast, towards the little clearing you know is there.

Silence, especially strange for this time of day, sits heavily in the clearing.

>se
Behind your cottage
Another small clearing behind your cottage. You do not come here very often, or anyway not lately.

You could wander back into the reeds to the south, or return to your garden by walking northwest or southwest around your home. The road lies to the north, where it runs east, vanishing into the dark wood.

The forest also looms to the east of where you now stand. An old fallen log reaches out of it, into the clearing.

Two standing stones mark the earth here, along the rear wall of the cottage. One, waist-high, stands larger than the other.

Behind the trunk, a stoat dines noisily on a stolen bird's egg, unaware of your presence.

>listen
All you can hear is that stoat.

>l
Behind your cottage
Another small clearing behind your cottage. You do not come here very often, or anyway not lately.

You could wander back into the reeds to the south, or return to your garden by walking northwest or southwest around your home. The road lies to the north, where it runs east, vanishing into the dark wood.

The forest also looms to the east of where you now stand. An old fallen log reaches out of it, into the clearing.

Two standing stones mark the earth here, along the rear wall of the cottage. One, waist-high, stands larger than the other.

Behind the trunk, a stoat dines noisily on a stolen bird's egg, unaware of your presence.

>z
Time passes.

Heedless of your standing there, the stoat continues lapping noisily at the spotted egg, its paws grasping the shell.

>get egg
(the speckled eggshell)
The little animal isn't so absorbed in its meal that it doesn't hear you approach. It pulls its head from the egg to regard you just as you draw near. Then, quick as a flash, it's gone, swallowed up by the forest.

It has left its egg behind.

You pick up the eggshell from where the little animal left it.

"Once you've found those eggshells," the tailor continued, "what you do is -- this sounds strange, but that's the whole point, see -- you need to fill them up with water. Then you carry them, one in each hand, like they're the heaviest buckets, you carry them right back into your cottage, and you show them to him."

He paused then, but you only nodded, unsure what to say to all this.

>listen
All is quiet again.

* * *

>look behind log
Tightening your grip on the stake, you peer behind the log, so that you can see the whole of the mushroom ring, and whatever else might sit inside it.

You see it. A skinny little man, wearing a... a fur coat, and a spotted cap? It's lying down, right in the center of the fairy ring, damn it all, and its tail twitches as it... oh.

You let go the breath you hadn't realized you were holding. No, it's not a little man. Though it is another sort of forest creature, true enough, and maybe no less wicked, in its way.

And that "cap" does catch your attention...

>get stoat
The little animal isn't so absorbed in its meal that it doesn't hear you approach. It pulls its head from the egg to regard you just as you draw near. Then, quick as a flash, it's gone, swallowed up by the forest.

It has left its egg behind.

>get egg
(the speckled eggshell)
You pick up the eggshell from where the little animal left it.

"Once you've found those eggshells," the tailor continued, "what you do is -- this sounds strange, but that's the whole point, see -- you need to fill them up with water. Then you carry them, one in each hand, like they're the heaviest buckets, you carry them right back into your cottage, and you show them to him."

He paused then, but you only nodded, unsure what to say to all this.

>sw
Outside the cottage
A space in front of your home, long ago cleared from the reed bank to the south. You can see the road from here, and of course the forest beyond it.

Your garden lies here, good earth and green, a row of stones marking it off.

The doorway to your cottage is to the east. You could also walk around the cottage, to the northeast or the southeast, towards the little clearing you know is there.

Silence, especially strange for this time of day, sits heavily in the clearing.

>s
Among the reeds
The familiar reed bank behind your cottage surrounds you, filling the damp space between your home and the river to the south.

One particularly tall stalk, topped with an early flower, marks the location of the reed bird's nest.

>s
Beach
A small bulge of sandy beach, providing a place to stand comfortably and access the river water clear of the reeds. The river to the south curves gently around it.

The river flows here, as it always has, clear and cool.

>fill egg with water
Which do you mean, the speckled eggshell or the cracked eggshell?

>speckled
(the river)
Careful not to spill any water from the other one, you crouch and fill the empty shell from the river. When you stand again, you hold two water-filled eggshells, one in each hand.

>n
Among the reeds
The familiar reed bank behind your cottage surrounds you, filling the damp space between your home and the river to the south.

One particularly tall stalk, topped with an early flower, marks the location of the reed bird's nest.

>x stalk
You walk towards the tall reed, but find yourself confused as you draw near. This doesn't seem like the place you found the nest earlier. Looking again around the reed bed, you see a number of flowering reeds just as tall as this one, and that nest is nowhere that you can see.

For a handspan of a moment, the breeze settles, and the reeds' rustling stops.
And again, the silence from the cottage presses down on you.

>n
Outside the cottage
A space in front of your home, long ago cleared from the reed bank to the south. You can see the road from here, and of course the forest beyond it.

Your garden lies here, good earth and green, a row of stones marking it off.

The doorway to your cottage is to the east. You could also walk around the cottage, to the northeast or the southeast, towards the little clearing you know is there.

Silence, especially strange for this time of day, sits heavily in the clearing.

Just as you step free of the reeds, the cracked eggshell in your hand gives way. In two eyeblinks, it collapses on itself, the water spilling between your fingers and the broken pieces of shell tumbling to the earth, useless now.

You look up, then, to the doorway of your cottage. Well. You held two full eggs. Maybe that was enough?

Maybe it had better be enough.

Maybe it's getting late (another reflexive look at the sky, still gray as ever), and maybe you are in the middle of something you don't fully ken, brought about by a man who isn't even here, and maybe you should bring an end to this before it gets any later.

>e
You pass over the woven reed mats that lie within the doorway, and then you are inside.

And then you turn to face it.

Though his words struck you as the most absurd thing, your hand moved to cover your breast. "But he's mine," you said, unable to come up with a stronger protest.

For even now, you could hear the wailing, the din that seldom stops, that hasn't in so many months.

And a dark, desperate part of you wanted to hear what the tailor had to say.

"I know of a test," he said.

Inside your cottage
Here is where you've lived for so many years, a cottage much like any other, a fine place to rest after a day gathering reeds or preparing thatch. Here you have made meals beyond counting, always for yourself, sometimes for another. It contains scattered furniture -- the largest being a table against one wall, and a cradle not far from it.

But right now, all your attention is on the chair.

The baby sits on the chair, held upright by the blanket you'd tied before you began your search.

>show egg to baby
You breathe, and gather yourself. Then you hang your arm down, making as if the eggshell is a heavy thing, hard to lift.

"Oh," you say, but it comes out as a croak.

"...Oh," you say again, louder. "I have brought back the whole river for the potage, and it is such a heavy thing! Do you see?"

You then lift up the eggshell, straining, as if it were a pail, filled to spilling.

"I've heard different things," said the tailor, "but they all agree that changelings can't abide humans acting strange, and using eggshells in a weird way will always set them off. When a changeling sees such a thing, it can't help but to leap up and declare, 'Crikey! I'm two hundred years old, and I've never seen anything queer as that!' Or something of the sort, anyway. And that's how you know you've got a changeling."

"But what would I do then?" you asked.

"Once it's revealed itself to you? That's simple," said the tailor. "Snatch it up, carry it out of your cottage, and throw it in the river. Throw it into the river, and its own kind will come for it. Then they'll have to return what they took from you."

The baby looks right at the eggshell with its dark, dull eyes. Then it opens its mouth.

"Cuh," it says. "C-cuh... Cruh..."

>examine table
Just a simple table, made of wood.

On the table is the pair of cold iron shears.

"And if the baby isn't a changeling?" you asked.

"Well," said the tailor, with a smile. "I suppose it won't say anything at all!"

"Cuh... k-kkaaaaaAAAAAAAAAAAAUUUUAAAAAAUUAAA..."

The baby begins howling, just as it has been, most every day, and most of every day. For so long.

But... it didn't start until it saw the eggshell, this time. Does that mean something? Did it... did it work?

What happens now?

>put egg on table
The eggshell tips over as soon as you set it down on the table. The water spills across the surface and onto the floor.

>get egg
Taken.

The baby thrashes in its cries, straining against the blanket.

* * *

>examine table
Just a simple table, made of wood.

On the table is the pair of cold iron shears.

"And if the baby isn't a changeling?" you asked.

"Well," said the tailor, with a smile. "I suppose it won't say anything at all!"

"Cuh... k-kkaaaaaAAAAAAAAAAAAUUUUAAAAAAUUAAA..."

The baby begins howling, just as it has been, most every day, and most of every day. For so long.

But... it didn't start until it saw the eggshell, this time. Does that mean something? Did it... did it work?

What happens now?

>get shears
You toss the stake aside.

The iron seems startlingly cold as you close your hand around it.

>stab baby
Blunt, hurtful thoughts crowd your mind as your grip tightens on the pair of cold iron shears. But you stay your hand.

Yes, once you may have tried to slap some quiet into the baby, or shake the noise out of it. (Maybe more than once. But surely not much more.)

But maybe that's just it. Maybe this isn't your baby after all, but a tricksome forest-creature, too old and patient to take a lesson from a mother's gentle hand.

Your head rings with the baby's inhuman howling as a dark thought crosses over you. Could it be true? Could this baby really be a changeling?

Is it true?

The baby thrashes in its cries, straining against the blanket.

* * *

>get shears
You toss the stake aside.

The iron seems startlingly cold as you close your hand around it.

>open shears
You allow yourself a couple of practice snips.

The baby thrashes in its cries, straining against the blanket.

>close shears
You allow yourself a couple of practice snips.

The baby shrieks and cries.

* * *

>get shears
You toss the stake aside.

The iron seems startlingly cold as you close your hand around it.

>touch baby with shears
Slowly, you bring the flat of the sharp blade up to the baby's cheek... but stop short, uncertain. So instead, you grasp one of the baby's little hands to keep it steady, and with your other hand press the cold blade across its arm.

The moment you do so, the baby squeezes your fingers with its tiny ones, strong. You draw back, nearly dropping the shears. The baby continues squealing.

The baby thrashes in its cries, straining against the blanket.

>hit baby with shears
I only understood you as far as wanting to hit the baby.

>x shears
Not the sort of tool you usually use for thatching, these were left here for a different purpose. One not so sure as shaping reeds, weaving them. There, at least, you know when you're done, when it works.

"Cold iron," he'd said, taking the spare pair of shears from his belt, holding it up for you to see. "They fear it, you know. An open pair of shears is especially frightful to them."

Before he left, you did the thing you did on his visits, at least since you'd been alone. Together, out in the reeds, away from the noise.

Payment, a bitter part of you thinks. But, no. It wasn't like that. It was nice.

A strangled gargle from the baby -- one of its usual sounds, but still startling -- brings you back to the present. You find that you'd been looking at the baby anyway, remembering.

The baby shrieks and cries.

>touch crib with shears
Nothing obvious happens.

>touch shears to baby
This time you do touch the flat of the shears' blade to the baby's cheek, after holding it steady with a hand acrross the forehead. The baby flinches away from the cold touch, shrieking. (Or, rather, carrying on with its shrieking.)

>hold shears to baby
You snip the shears, idly, gazing at the squirming baby. No... doubt and discomfort stop you from running this test any further.

The baby shrieks and cries.

>hold baby to shears
(first taking the baby)
The blanket is tied fast to the chair, in such a way that it restrains the baby from slipping out.

The baby's cries subside for a few heartbeats, then resume as loud as before.

>put shears on baby
No... doubt and discomfort stop you from running this test any further.

The baby's cries subside for a few heartbeats, then resume as loud as before.

>drop shears
Dropped.

For a strange moment, you think you hear the reed-bird calling again, outside. But the baby starts in again, wiping the sound from the air and your ears.

>put shears on baby
(first taking the pair of cold iron shears)
No... doubt and discomfort stop you from running this test any further.

The baby's wails reach a peak, rattling the bones in your head.

* * *

>touch crib with shears
Nothing obvious happens.

>touch baby with eggshell
Nothing obvious happens.

>touch baby with me
You run your finger down the baby's warm cheek, damp with tears and snot.

The baby shrieks and cries.

>touch baby with shears
This time you do touch the flat of the shears' blade to the baby's cheek, after holding it steady with a hand acrross the forehead. The baby flinches away from the cold touch, shrieking. (Or, rather, carrying on with its shrieking.)

The baby's cries subside for a few heartbeats, then resume as loud as before.

>g
You snip the shears, idly, gazing at the squirming baby. No... doubt and discomfort stop you from running this test any further.

The baby's cries subside for a few heartbeats, then resume as loud as before.

>g
No... doubt and discomfort stop you from running this test any further.

For a strange moment, you think you hear the reed-bird calling again, outside. But the baby starts in again, wiping the sound from the air and your ears.

* * *

>touch baby with me
You run your finger down the baby's warm cheek, damp with tears and snot.

The baby shrieks and cries.

>touch baby with hands
You run your finger down the baby's warm cheek, damp with tears and snot.

The baby's cries subside for a few heartbeats, then resume as loud as before.

* * *

>get shears
You toss the stake aside.

The iron seems startlingly cold as you close your hand around it.

>cut blanket
The cold iron of the shears bites into the blanket.

It was a hard birth. Not like the last one, but hard. Still, it ended with you holding the babe in your arms. Without words to describe how you felt, what you said was this:

Anda.

You really hadn't thought of a name before now, and all at once it seemed strange that you hadn't, though you hadn't really anyone to talk to about it. But at that moment you knew it was the right name. Anda, you said again.

The blanket now lies raggedly open on the chair, with the baby sitting atop it.

The baby thrashes in its cries, nearly falling from the chair.

>get baby
You carefully lift the baby, cradling it in your arms.

The baby shrieks and cries.

>w
The baby in your arms, you pause at the doorway, considering the darkening sky outside, the way the wind shakes the reeds.

The river that you know is there.

Your head rings with the baby's inhuman howling as a dark thought crosses over you. Could it be true? Could this baby really be a changeling?

Is it true?

(You take a step backwards, away from the doorway. For now.)

>yes
Cold, welcome certainty calms your heart and stills your shaking hands. Yes. Of course this isn't really your baby. Just look at it. Just listen to it, you think to yourself, and catch yourself almost laughing, giddily. As if you've had any choice but to listen, all this time!

It is a monster, a creature of the forest, come to play you for a fool, and it did. For a while. But God bless that tailor for knowing what to do.

And now you know what you have to do, too.

>w
Holding the squirming, bawling creature at arms' length, you walk back out into the windy evening. 

You wonder how the exchange will happen. Perhaps they already know that their trick is ended, and they will be waiting for you with your real baby. Or maybe you'll come back home to find him asleep in the crib; you're rather sure you've heard of that happening before. Either way, they'll have to return him, once you throw their false child back to them. That's simply how it works.

You can't help but smile, looking forward to seeing your child again, as you make your way south, towards the river.

    *** The End ***

Would you like to RESTART, RESTORE a saved game, QUIT or UNDO the last command?

* * *

>get baby
You carefully lift the baby, cradling it in your arms.

The baby shrieks and cries.

>drop baby
You look at the door. Then you look at the crib. Your head rings with the baby's crying, and your thoughts feel clouded. You can't just drop it, but...

>put baby in crib
You pause, catching yourself thinking, in spite of all the confusion: the baby just needs to be put to bed, is all. And how many times have you thought that before! And yet, more than once -- often, in fact -- you've found yourself watching over the baby in its cradle, sleeping softly, and couldn't imagine yourself belonging anywhere else.

Oh yes, sighs the darker part of you. Very easy, because that's the only time it's quiet. That and when it's feeding.

For a moment, you close your ears to the cries, and you try to close your mind to what he had suggested, to the fact that you may have even felt some perverse disappointment with the fact that the baby hadn't leapt up and begun to talk in Goblin-tongue rhyme when it saw the eggshell.

But maybe that's all there is to it. Maybe it was all just a foolish suggestion from a foolish man.

Is this really your baby?

(You still hold the baby, uncertain.)

>yes
But, no. Between the baby's shrieking and... and everything else, you just can't...

There is something missing.

>put baby in crib
But, no. Between the baby's wailing and... and everything else, you just can't...

There is something missing.

(You still hold the baby, uncertain.)

The baby thrashes in its cries, straining against your grasp.

>g
But, no. Between the baby's shrieking and... and everything else, you just can't...

There is something missing.

A name.

(You still hold the baby, uncertain.)

For a strange moment, you think you hear the reed-bird calling again, outside. But the baby starts in again, wiping the sound from the air and your ears.

>name baby
That's right, the baby does have a name...

The baby's wails reach a peak, rattling the bones in your head.

>name me
That already has a name, and not by you.

>say anda
Anda.

Yes.

You step back and look at the baby, at its face. Yes, its features are all twisted up by its crying, and yes, maybe they're a little strange just the same.

But the deeper resemblance is undeniable. Part of you wants to curse his cowardice for suggesting that it was any other way. But, there will be time for that later.

The rest of you, the whole of your heart, reaches out to the child. You know, as sure as the day it was born, that it -- that he -- is truly yours.

>put baby in crib
Gently, you lower Anda into his cradle, then pull up the chair beside it and sit. You yourself can barely hear the lullaby you sing over his crying, but you know that soon enough he'll sleep.

And soon enough again, God willing, he'll grow. Growing is what babies do, and this is your baby.

    *** The End ***

Would you like to RESTART, RESTORE a saved game, see some suggestions for AMUSING things to do, QUIT or UNDO the last command?

* * *

>get baby
You carefully lift the baby, cradling it in your arms.

The baby shrieks and cries.

>hug baby
You pause, catching yourself wanting to go through the familiar motions, in spite of all the confusion. So young, but still you've lost count of the days, the number of times you've lifted the baby, just to hold, or to hold to your breast. And weren't those some of the most quietly pleasant times you've spent with the baby, despite everything?

Quiet, yes, says the darker part of you. Quiet because that's the only time it doesn't cry, that and sleeping. And you hear thoughts darker still -- They cry and carry on so, because they're greedy, greedier than any human child would be --  but you know those words aren't yours.

For a moment, you close your ears to the cries, and you try to close your mind to what he had suggested, to the fact that you may have even felt some perverse disappointment with the fact that the baby hadn't leapt up and begun to talk in Goblin-tongue rhyme when it saw the eggshell.

But maybe that's all there is to it. Maybe it was all just a foolish suggestion from a foolish man.

Is this really your baby?

(You find yourself still holding the baby, uncertain and trembling.)

>yes
But, no. Between the baby's wailing and... and everything else, you just can't...

There is something missing.

The baby shrieks and cries.

>name baby
That's right, the baby does have a name...

The baby's cries subside for a few heartbeats, then resume as loud as before.

>touch baby
You run your finger down the baby's warm cheek, damp with tears and snot.

The baby's cries subside for a few heartbeats, then resume as loud as before.

* * *

>name baby
That's right, the baby does have a name...

The baby's cries subside for a few heartbeats, then resume as loud as before.

>anda
Anda.

Yes.

You step back and look at the baby, at its face. Yes, its features are all twisted up by its crying, and yes, maybe they're a little strange just the same.

But the deeper resemblance is undeniable. Part of you wants to curse his cowardice for suggesting that it was any other way. But, there will be time for that later.

The rest of you, the whole of your heart, reaches out to the child. You know, as sure as the day it was born, that it -- that he -- is truly yours.

Anda's cries subside for a few heartbeats, then resume as loud as before.

>touch baby
You gently stroke his thin, black hair.

For a strange moment, you think you hear the reed-bird calling again, outside. But Anda starts in again, wiping the sound from the air and your ears.

* * *

>anda
Anda.

Yes.

You step back and look at the baby, at its face. Yes, its features are all twisted up by its crying, and yes, maybe they're a little strange just the same.

But the deeper resemblance is undeniable. Part of you wants to curse his cowardice for suggesting that it was any other way. But, there will be time for that later.

The rest of you, the whole of your heart, reaches out to the child. You know, as sure as the day it was born, that it -- that he -- is truly yours.

Anda's cries subside for a few heartbeats, then resume as loud as before.

>touch baby with shears
The time for such tests is past.

For a strange moment, you think you hear the reed-bird calling again, outside. But Anda starts in again, wiping the sound from the air and your ears.

* * *

>anda
Anda.

Yes.

You step back and look at the baby, at its face. Yes, its features are all twisted up by its crying, and yes, maybe they're a little strange just the same.

But the deeper resemblance is undeniable. Part of you wants to curse his cowardice for suggesting that it was any other way. But, there will be time for that later.

The rest of you, the whole of your heart, reaches out to the child. You know, as sure as the day it was born, that it -- that he -- is truly yours.

Anda's cries subside for a few heartbeats, then resume as loud as before.

>hug baby
You slip your shift down one shoulder, and cradle Anda up to your breast. "Hush," you whisper to him. "Hush. There," as he begins to suckle, once again.

As you sing softly, you know that Anda's peace won't last. 

But babies grow up. They must. And this is your baby.

    *** The End ***

Would you like to RESTART, RESTORE a saved game, see some suggestions for AMUSING things to do, QUIT or UNDO the last command?

* * *

>get chair
Now is no time to move your furniture around.

The baby shrieks and cries.

* * *

>examine table
Just a simple table, made of wood.

On the table is the pair of cold iron shears.

"And if the baby isn't a changeling?" you asked.

"Well," said the tailor, with a smile. "I suppose it won't say anything at all!"

"Cuh... k-kkaaaaaAAAAAAAAAAAAUUUUAAAAAAUUAAA..."

The baby begins howling, just as it has been, most every day, and most of every day. For so long.

But... it didn't start until it saw the eggshell, this time. Does that mean something? Did it... did it work?

What happens now?

>yes
That was a rhetorical question.

>kill baby
Blunt, hurtful thoughts crowd your mind as your grip tightens on the stake. But you stay your hand.

Yes, once you may have tried to slap some quiet into the baby, or shake the noise out of it. (Maybe more than once. But surely not much more.)

But maybe that's just it. Maybe this isn't your baby after all, but a tricksome forest-creature, too old and patient to take a lesson from a mother's gentle hand.

Your head rings with the baby's inhuman howling as a dark thought crosses over you. Could it be true? Could this baby really be a changeling?

Is it true?

The baby thrashes in its cries, straining against the blanket.

>g
The hurtful thoughts press on your mind again.

Cold, welcome certainty calms your heart and stills your shaking hands. Yes. Of course this isn't really your baby. Just look at it. Just listen to it, you think to yourself, and catch yourself almost laughing, giddily. As if you've had any choice but to listen, all this time!

It is a monster, a creature of the forest, come to play you for a fool, and it did. For a while. But God bless that tailor for knowing what to do.

And now you know what you have to do, too.
Maybe it would feel good to make the vile little thing pay for all it's taken from you. But you know that's not the proper way to dispose of this creature, and the cost would be too high. Leaving aside the question of whether it's a mortal sin to kill a changeling, it's doubtful you'd see your real child again.

There's a better way.

The changeling shrieks and cries.

>cut baby
Maybe it would feel good to make the vile little thing pay for all it's taken from you. But you know that's not the proper way to dispose of this creature, and the cost would be too high. Leaving aside the question of whether it's a mortal sin to kill a changeling, it's doubtful you'd see your real child again.

There's a better way.

* * *

>examine table
Just a simple table, made of wood.

On the table is the pair of cold iron shears.

"And if the baby isn't a changeling?" you asked.

"Well," said the tailor, with a smile. "I suppose it won't say anything at all!"

"Cuh... k-kkaaaaaAAAAAAAAAAAAUUUUAAAAAAUUAAA..."

The baby begins howling, just as it has been, most every day, and most of every day. For so long.

But... it didn't start until it saw the eggshell, this time. Does that mean something? Did it... did it work?

What happens now?

>x changeling
Changeling.

Your head rings with the baby's inhuman howling as a dark thought crosses over you. Could it be true? Could this baby really be a changeling?

Is it true?

>yes
Cold, welcome certainty calms your heart and stills your shaking hands. Yes. Of course this isn't really your baby. Just look at it. Just listen to it, you think to yourself, and catch yourself almost laughing, giddily. As if you've had any choice but to listen, all this time!

It is a monster, a creature of the forest, come to play you for a fool, and it did. For a while. But God bless that tailor for knowing what to do.

And now you know what you have to do, too.

The changeling thrashes in its cries, straining against the blanket.

>untie blanket
You see no way to do that while still holding onto that water-filled eggshell.

The changeling shrieks and cries.

>sing
You know from experience that singing does little good now, while the changeling is fully caught up in its crying fits.

* * *

>untie blanket
You see no way to do that while still holding onto that water-filled eggshell.

The changeling shrieks and cries.

>drop eggshell
You dash the eggshell onto the ground. Bits of shell fly everywhere, and the water it contained sinks into the packed-earth floor.

>untie blanket
You easily undo your earlier work. Now the blanket lies untied, with the changeling sitting atop it.

>get baby
You snatch up the changeling, heedless of its wailing.

The changeling shrieks and cries.

>w
Holding the squirming, bawling creature at arms' length, you walk back out into the windy evening. 

You wonder how the exchange will happen. Perhaps they already know that their trick is ended, and they will be waiting for you with your real baby. Or maybe you'll come back home to find him asleep in the crib; you're rather sure you've heard of that happening before. Either way, they'll have to return him, once you throw their false child back to them. That's simply how it works.

You can't help but smile, looking forward to seeing your child again, as you make your way south, towards the river.

    *** The End ***

Would you like to RESTART, RESTORE a saved game, QUIT or UNDO the last command?

* * *

>get baby
You snatch up the changeling, heedless of its wailing.

The changeling shrieks and cries.

>touch baby
You poke at the creature. It just keeps bawling, of course.

The changeling's cries subside for a few heartbeats, then resume as loud as before.

* * *

>get baby
You snatch up the changeling, heedless of its wailing.

The changeling shrieks and cries.

>touch baby with shears
(first taking the pair of cold iron shears)
You toss the stake aside.

The iron seems startlingly cold as you close your hand around it.

The time for such tests is past.

The changeling's cries subside for a few heartbeats, then resume as loud as before.

* * *

>untie blanket
You see no way to do that while still holding onto that water-filled eggshell.

The changeling shrieks and cries.

>x hands
Your hands are steady again.

* * *

>get all from table
You toss the stake aside.

The iron seems startlingly cold as you close your hand around it.

"And if the baby isn't a changeling?" you asked.

"Well," said the tailor, with a smile. "I suppose it won't say anything at all!"

"Cuh... k-kkaaaaaAAAAAAAAAAAAUUUUAAAAAAUUAAA..."

The baby begins howling, just as it has been, most every day, and most of every day. For so long.

But... it didn't start until it saw the eggshell, this time. Does that mean something? Did it... did it work?

What happens now?

>x hands
Your hands tremble and shake.

>x ground
Only the ground.

The baby thrashes in its cries, straining against the blanket.

>x d
Only the ground.

The baby shrieks and cries.

* * *

>out
Not now. Listen...

"And if the baby isn't a changeling?" you asked.

"Well," said the tailor, with a smile. "I suppose it won't say anything at all!"

"Cuh... k-kkaaaaaAAAAAAAAAAAAUUUUAAAAAAUUAAA..."

The baby begins howling, just as it has been, most every day, and most of every day. For so long.

But... it didn't start until it saw the eggshell, this time. Does that mean something? Did it... did it work?

What happens now?

>out
No, this isn't right. You must have done something wrong again. It was that broken egg, surely.

There's still time, surely. Maybe you will try the forest this time.

Maybe, when you get there, you'll just keep walking.

    *** The End ***

Would you like to RESTART, RESTORE a saved game, QUIT or UNDO the last command?

* * *

>x furniture
Your cooking-pot, your sleeping mat... nothing of importance right now.

>x shell
That stoat did a neat job with this one. The egg's top is cleanly bit away, and the inside licked clean, leaving the shell whole.

In the speckled eggshell is some water.

>x water
Water from the river.

>show water to baby
You breathe, and gather yourself. Then you hang your arm down, making as if the eggshell is a heavy thing, hard to lift.

"Oh," you say, but it comes out as a croak.

"...Oh," you say again, louder. "I have brought back the whole river for the potage, and it is such a heavy thing! Do you see?"

You then lift up the eggshell, straining, as if it were a pail, filled to spilling.

"I've heard different things," said the tailor, "but they all agree that changelings can't abide humans acting strange, and using eggshells in a weird way will always set them off. When a changeling sees such a thing, it can't help but to leap up and declare, 'Crikey! I'm two hundred years old, and I've never seen anything queer as that!' Or something of the sort, anyway. And that's how you know you've got a changeling."

"But what would I do then?" you asked.

"Once it's revealed itself to you? That's simple," said the tailor. "Snatch it up, carry it out of your cottage, and throw it in the river. Throw it into the river, and its own kind will come for it. Then they'll have to return what they took from you."

The baby looks right at the eggshell with its dark, dull eyes. Then it opens its mouth.

"Cuh," it says. "C-cuh... Cruh..."

>g
"And if the baby isn't a changeling?" you asked.

"Well," said the tailor, with a smile. "I suppose it won't say anything at all!"

"Cuh... k-kkaaaaaAAAAAAAAAAAAUUUUAAAAAAUUAAA..."

The baby begins howling, just as it has been, most every day, and most of every day. For so long.

But... it didn't start until it saw the eggshell, this time. Does that mean something? Did it... did it work?

What happens now?

>g
Once again, you hold up the eggshell, acting like it's a heavy thing. "See the eggshell? See how heavy?"

The baby continues to wail.

* * *

>x furniture
Your cooking-pot, your sleeping mat... nothing of importance right now.

>get shears
You toss the stake aside.

The iron seems startlingly cold as you close your hand around it.

>touch baby with shears
Yes, that might work as a test, too. But you'd best see through the eggshell test first.

>x hands
They've done so much, haven't they?

>show shears to baby
You hold up the shears for the baby to see. But it doesn't react in any way that you can tell. It only continues to stare at the eggshell you carry.

* * *

>sw
Outside the cottage
A space in front of your home, long ago cleared from the reed bank to the south. You can see the road from here, and of course the forest beyond it.

Your garden lies here, good earth and green, a row of stones marking it off.

The doorway to your cottage is to the east. You could also walk around the cottage, to the northeast or the southeast, towards the little clearing you know is there.

Silence, especially strange for this time of day, sits heavily in the clearing.

>e
The silence is strange, all right. But you haven't been out of the house that long, and don't plan on being out that much longer.

You chose to take up this task, and you'd best see it through... before facing what's in there.

"Then fill both the shells with water," he said, "and carry them into your cottage..."

>s
Among the reeds
The familiar reed bank behind your cottage surrounds you, filling the damp space between your home and the river to the south.

One particularly tall stalk, topped with an early flower, marks the location of the reed bird's nest.

* * *

>s
Beach
A small bulge of sandy beach, providing a place to stand comfortably and access the river water clear of the reeds. The river to the south curves gently around it.

The river flows here, as it always has, clear and cool.

>fill eggs
What do you want to fill those things with?

>water
(the river)
speckled eggshell: Careful not to spill any water from the other one, you crouch and fill the empty shell from the river. When you stand again, you hold two water-filled eggshells, one in each hand.
cracked eggshell: Fill the same eggshell twice? No, you wouldn't try to fool with things that way. Best to find another empty one.

>n
Among the reeds
The familiar reed bank behind your cottage surrounds you, filling the damp space between your home and the river to the south.

One particularly tall stalk, topped with an early flower, marks the location of the reed bird's nest.

>n
Outside the cottage
A space in front of your home, long ago cleared from the reed bank to the south. You can see the road from here, and of course the forest beyond it.

Your garden lies here, good earth and green, a row of stones marking it off.

The doorway to your cottage is to the east. You could also walk around the cottage, to the northeast or the southeast, towards the little clearing you know is there.

Silence, especially strange for this time of day, sits heavily in the clearing.

Just as you step free of the reeds, the cracked eggshell in your hand gives way. In two eyeblinks, it collapses on itself, the water spilling between your fingers and the broken pieces of shell tumbling to the earth, useless now.

You look up, then, to the doorway of your cottage. Well. You held two full eggs. Maybe that was enough?

Maybe it had better be enough.

Maybe it's getting late (another reflexive look at the sky, still gray as ever), and maybe you are in the middle of something you don't fully ken, brought about by a man who isn't even here, and maybe you should bring an end to this before it gets any later.

* * *

>look behind log
Tightening your grip on the stake, you peer behind the log, so that you can see the whole of the mushroom ring, and whatever else might sit inside it.

You see it. A skinny little man, wearing a... a fur coat, and a spotted cap? It's lying down, right in the center of the fairy ring, damn it all, and its tail twitches as it... oh.

You let go the breath you hadn't realized you were holding. No, it's not a little man. Though it is another sort of forest creature, true enough, and maybe no less wicked, in its way.

And that "cap" does catch your attention...

>get egg
(the speckled eggshell)
The little animal isn't so absorbed in its meal that it doesn't hear you approach. It pulls its head from the egg to regard you just as you draw near. Then, quick as a flash, it's gone, swallowed up by the forest.

It has left its egg behind.

You pick up the eggshell from where the little animal left it.

"Once you've found those eggshells," the tailor continued, "what you do is -- this sounds strange, but that's the whole point, see -- you need to fill them up with water. Then you carry them, one in each hand, like they're the heaviest buckets, you carry them right back into your cottage, and you show them to him."

He paused then, but you only nodded, unsure what to say to all this.

>x clearing
You stand in the small space that separates your home from the forest, and its shadows.

>x shadows
The green of the nearby forest seems thicker today. The shadows, thicker.

* * *

>ne
Behind your cottage
Another small clearing behind your cottage. You do not come here very often, or anyway not lately.

You could wander back into the reeds to the south, or return to your garden by walking northwest or southwest around your home. The road lies to the north, where it runs east, vanishing into the dark wood.

The forest also looms to the east of where you now stand. An old fallen log reaches out of it, into the clearing.

Two standing stones mark the earth here, along the rear wall of the cottage. One, waist-high, stands larger than the other.

* * *

>drop stake
(the stake)
Dropped.

>ne
Hearing that scratching, snuffling sound again, you hesitate. All you're carrying is this eggshell, and you'd feel bolder if you held something a bit more solid. Something that would do in a pinch, if it came to it.

* * *

>get stake
You pull one of the stakes out of the earth, and wrap your hand tightly around one end, holding like a club.

You realize what's wrong now. It's quiet.

You were so involved among the reeds just now that you hadn't paid it mind, but: the cottage is silent.

>ne
You take a few steps around the side of the cottage, but stop short when a soft sound breaks the heavy silence. A scrabbling, snuffling sort of sound, coming from behind the cottage.

It sounds like something alive.

The tailor gestured to some mushrooms growing near your garden. "Fairy ring," he said. "These grow where they gather and dance, in the forest, and also where they mean to meddle, in the places we live." Looking again, yes, the mushrooms did seem to have a sort of circular pattern to them.

"You musn't let them grow so near your home like this, first of all," he said, "as it makes them bolder."

"All right," you said, unsure why his voice seemed so heavy with concern. "I can just treat them like the weeds in the garden, then."

"Yes..." he said, and paused before looking at you again.

"There's something else."

You remain in the garden, and in the not-quite-silence.

* * *

>l
Outside the cottage
A space in front of your home, long ago cleared from the reed bank to the south. You can see the road from here, and of course the forest beyond it.

Your garden lies here, good earth and green, a row of stones marking it off.

The doorway to your cottage is to the east. You could also walk around the cottage, to the northeast or the southeast, towards the little clearing you know is there.

Silence, especially strange for this time of day, sits heavily in the clearing.

>ne
Behind your cottage
Another small clearing behind your cottage. You do not come here very often, or anyway not lately.

You could wander back into the reeds to the south, or return to your garden by walking northwest or southwest around your home. The road lies to the north, where it runs east, vanishing into the dark wood.

The forest also looms to the east of where you now stand. An old fallen log reaches out of it, into the clearing.

Two standing stones mark the earth here, along the rear wall of the cottage. One, waist-high, stands larger than the other.

* * *

>look behind log
Tightening your grip on the stake, you peer behind the log, so that you can see the whole of the mushroom ring, and whatever else might sit inside it.

You see it. A skinny little man, wearing a... a fur coat, and a spotted cap? It's lying down, right in the center of the fairy ring, damn it all, and its tail twitches as it... oh.

You let go the breath you hadn't realized you were holding. No, it's not a little man. Though it is another sort of forest creature, true enough, and maybe no less wicked, in its way.

And that "cap" does catch your attention...

>x stoat
Normally, forest animals like this stoat shy from people, but this one hasn't noticed you. This is because it has buried its snout into a bird's egg, which it is now licking clean. You can plainly hear its loud lapping and snuffling as it works to clean out every wet morsel.

>sw
Outside the cottage
A space in front of your home, long ago cleared from the reed bank to the south. You can see the road from here, and of course the forest beyond it.

Your garden lies here, good earth and green, a row of stones marking it off.

The doorway to your cottage is to the east. You could also walk around the cottage, to the northeast or the southeast, towards the little clearing you know is there.

Silence, especially strange for this time of day, sits heavily in the clearing.

* * *

>get egg
Holding it, you now see that the egg's surface is webbed with cracks, as if it had been dropped.

The reed-bird goes about the business of feeding its young.

The reed-bird darts away again, perhaps looking for more food for its enormous chick.

>n
Outside the cottage
A space in front of your home, long ago cleared from the reed bank to the south. You can see the road from here, and of course the forest beyond it.

Your garden lies here, good earth and green, a row of stones marking it off.

The doorway to your cottage is to the east. You could also walk around the cottage, to the northeast or the southeast, towards the little clearing you know is there.

Something is wrong.

* * *

>look behind log
Tightening your grip on the rock, you peer behind the log, so that you can see the whole of the mushroom ring, and whatever else might sit inside it.

You see it. A skinny little man, wearing a... a fur coat, and a spotted cap? It's lying down, right in the center of the fairy ring, damn it all, and its tail twitches as it... oh.

You let go the breath you hadn't realized you were holding. No, it's not a little man. Though it is another sort of forest creature, true enough, and maybe no less wicked, in its way.

And that "cap" does catch your attention...

>get egg
(the speckled eggshell)
The little animal isn't so absorbed in its meal that it doesn't hear you approach. It pulls its head from the egg to regard you just as you draw near. Then, quick as a flash, it's gone, swallowed up by the forest.

It has left its egg behind.

You pick up the eggshell from where the little animal left it.

"Once you've found those eggshells," the tailor continued, "what you do is -- this sounds strange, but that's the whole point, see -- you need to fill them up with water. Then you carry them, one in each hand, like they're the heaviest buckets, you carry them right back into your cottage, and you show them to him."

He paused then, but you only nodded, unsure what to say to all this.

>sw
Outside the cottage
A space in front of your home, long ago cleared from the reed bank to the south. You can see the road from here, and of course the forest beyond it.

Your garden lies here, good earth and green, a row of stones marking it off.

The doorway to your cottage is to the east. You could also walk around the cottage, to the northeast or the southeast, towards the little clearing you know is there.

Silence, especially strange for this time of day, sits heavily in the clearing.

>s
The wind shifts the reeds, hiding the bird's nest from sight. You still see the tall stalk marking where you found it earlier, not far away.

Among the reeds
The familiar reed bank behind your cottage surrounds you, filling the damp space between your home and the river to the south.

One particularly tall stalk, topped with an early flower, marks the location of the reed bird's nest.

>s
Beach
A small bulge of sandy beach, providing a place to stand comfortably and access the river water clear of the reeds. The river to the south curves gently around it.

The river flows here, as it always has, clear and cool.

>i
You are carrying:
  the speckled eggshell
  a rock
  a small cracked egg (closed)

>open egg
(the small cracked egg)
Peeling away the topmost fragments from the egg's shell reveals the tiny body of a dead chick, unborn, encased in a veined and rotting yolk.

You manage to keep your grip on the shell, just the same.

>pour egg
(the cracked eggshell)
Grimacing, you upend the egg. The dead thing and its murky goo tumble out wetly. You turn your head away, not caring to see what becomes of it.

The shell is empty now.

>g
Which do you mean, the speckled eggshell or the cracked eggshell?

>put water in cracked
You dip the eggshell into the river, then stand back up again, careful not to spill any.

>pour egg
(the cracked eggshell)
Better that you don't spill it, right now.

* * *

>i
You are carrying:
  the speckled eggshell
  a rock
  a small cracked egg (closed)

>open small
Peeling away the topmost fragments from the egg's shell reveals the tiny body of a dead chick, unborn, encased in a veined and rotting yolk.

You manage to keep your grip on the shell, just the same.

>pour small
Grimacing, you upend the egg. The dead thing and its murky goo tumble out wetly. You turn your head away, not caring to see what becomes of it.

The shell is empty now.

>fill eggs
What do you want to fill those things with?

>water
speckled eggshell: You dip the eggshell into the river, then stand back up again, careful not to spill any.
cracked eggshell: Careful not to spill any water from the other one, you crouch and fill the empty shell from the river. When you stand again, you hold two water-filled eggshells, one in each hand.

* * *

>pour small
Grimacing, you upend the egg. The dead thing and its murky goo tumble out wetly. You turn your head away, not caring to see what becomes of it.

The shell is empty now.

>get river
(with the speckled eggshell)
You dip the eggshell into the river, then stand back up again, careful not to spill any.

(with the cracked eggshell)
Careful not to spill any water from the other one, you crouch and fill the empty shell from the river. When you stand again, you hold two water-filled eggshells, one in each hand.

* * *

>pour small
Grimacing, you upend the egg. The dead thing and its murky goo tumble out wetly. You turn your head away, not caring to see what becomes of it.

The shell is empty now.

>n
Among the reeds
The familiar reed bank behind your cottage surrounds you, filling the damp space between your home and the river to the south.

One particularly tall stalk, topped with an early flower, marks the location of the reed bird's nest.

>n
Outside the cottage
A space in front of your home, long ago cleared from the reed bank to the south. You can see the road from here, and of course the forest beyond it.

Your garden lies here, good earth and green, a row of stones marking it off.

The doorway to your cottage is to the east. You could also walk around the cottage, to the northeast or the southeast, towards the little clearing you know is there.

Silence, especially strange for this time of day, sits heavily in the clearing.

>e
The silence is strange, all right. But you haven't been out of the house that long, and don't plan on being out that much longer.

You chose to take up this task, and you'd best see it through... before facing what's in there.

"Then fill both the shells with water," he said, "and carry them into your cottage..."

* * *

>pour small
Grimacing, you upend the egg. The dead thing and its murky goo tumble out wetly. You turn your head away, not caring to see what becomes of it.

The shell is empty now.

>put water into eggs
speckled eggshell: You dip the eggshell into the river, then stand back up again, careful not to spill any.
cracked eggshell: Careful not to spill any water from the other one, you crouch and fill the empty shell from the river. When you stand again, you hold two water-filled eggshells, one in each hand.

* * *

>n
Outside the cottage
A space in front of your home, long ago cleared from the reed bank to the south. You can see the road from here, and of course the forest beyond it.

Your garden lies here, good earth and green, a row of stones marking it off.

The doorway to your cottage is to the east. You could also walk around the cottage, to the northeast or the southeast, towards the little clearing you know is there.

Something is wrong.

* * *

>get rock
You pull a small, round rock from the earth. Amidst worries of eggshells, you find comfort in its solid heft.

Taken.

>ne
Behind your cottage
Another small clearing behind your cottage. You do not come here very often, or anyway not lately.

You could wander back into the reeds to the south, or return to your garden to the northwest or southwest. The road lies to the north, and the forest looms not just there but here, to the east, where an old fallen log juts into the clearing.

Two standing stones mark the earth here, along the rear wall of the cottage. One, waist-high, stands larger than the other.

You hear that snuffling noise again, from somewhere very near.

>z
Time passes.

>z
Time passes.

>z
Time passes.

That one noise within the silence is very close by.

>z
Time passes.

You hear that snuffling noise again, from somewhere very near.

* * *

>n
Outside the cottage
A space in front of your home, long ago cleared from the reed bank to the south. You can see the road from here, and of course the forest beyond it.

Your garden lies here, good earth and green, a row of stones marking it off.

The doorway to your cottage is to the east. You could also walk around the cottage, to the northeast or the southeast, towards the little clearing you know is there.

Something is wrong.

>ne
You look down the path leading behind the cottage, but find yourself frozen to the spot, listening...

You realize what's wrong now. It's quiet.

You were so involved among the reeds just now that you hadn't paid it mind, but: the cottage is silent.

>ne
You take a few steps around the side of the cottage, but stop short when a soft sound breaks the heavy silence. A scrabbling, snuffling sort of sound, coming from behind the cottage.

It sounds like something alive.

The tailor gestured to some mushrooms growing near your garden. "Fairy ring," he said. "These grow where they gather and dance, in the forest, and also where they mean to meddle, in the places we live." Looking again, yes, the mushrooms did seem to have a sort of circular pattern to them.

"You musn't let them grow so near your home like this, first of all," he said, "as it makes them bolder."

"All right," you said, unsure why his voice seemed so heavy with concern. "I can just treat them like the weeds in the garden, then."

"Yes..." he said, and paused before looking at you again.

"There's something else."

You remain in the garden, and in the not-quite-silence.

>ne
Hearing that scratching, snuffling sound again, you hesitate. You are empty-handed, and you'd feel bolder if you held something solid. Something that would do in a pinch, if it came to it.

>ne
Hearing that scratching, snuffling sound again, you hesitate. You are empty-handed, and you'd feel bolder if you held something solid. Something that would do in a pinch, if it came to it.

* * *

>kill ring
Controlling your breath, you approach the fairy ring.

Tightening your grip on the stake, you peer behind the log, so that you can see the whole of the mushroom ring, and whatever else might sit inside it.

You see it. A skinny little man, wearing a... a fur coat, and a spotted cap? It's lying down, right in the center of the fairy ring, damn it all, and its tail twitches as it... oh.

You let go the breath you hadn't realized you were holding. No, it's not a little man. Though it is another sort of forest creature, true enough, and maybe no less wicked, in its way.

And that "cap" does catch your attention...

>get egg
The little animal isn't so absorbed in its meal that it doesn't hear you approach. It pulls its head from the egg to regard you just as you draw near. Then, quick as a flash, it's gone, swallowed up by the forest.

It has left its egg behind.

You pick up the eggshell from where the little animal left it.

>l
Behind your cottage
Another small clearing behind your cottage. You do not come here very often, or anyway not lately.

You could wander back into the reeds to the south, or return to your garden by walking northwest or southwest around your home. The road lies to the north, where it runs east, vanishing into the dark wood.

The forest also looms to the east of where you now stand. An old fallen log reaches out of it, into the clearing.

Two standing stones mark the earth here, along the rear wall of the cottage. One, waist-high, stands larger than the other.

>look in log
Nothing behind the log now, except for the other mushrooms -- making the circular pattern they form especially clear.

* * *

>look behind log
Tightening your grip on the stake, you peer behind the log, so that you can see the whole of the mushroom ring, and whatever else might sit inside it.

You see it. A skinny little man, wearing a... a fur coat, and a spotted cap? It's lying down, right in the center of the fairy ring, damn it all, and its tail twitches as it... oh.

You let go the breath you hadn't realized you were holding. No, it's not a little man. Though it is another sort of forest creature, true enough, and maybe no less wicked, in its way.

And that "cap" does catch your attention...

>g
Normally, forest animals like this stoat shy from people, but this one hasn't noticed you. This is because it has buried its snout into a bird's egg, which it is now licking clean. You can plainly hear its loud lapping and snuffling as it works to clean out every wet morsel.

>get egg
The little animal isn't so absorbed in its meal that it doesn't hear you approach. It pulls its head from the egg to regard you just as you draw near. Then, quick as a flash, it's gone, swallowed up by the forest.

It has left its egg behind.

You pick up the eggshell from where the little animal left it.

>look behind log
Nothing behind the log now, except for the other mushrooms -- making the circular pattern they form especially clear.

>kill mushrooms
Grunting, you kick one of the mushrooms, maybe a little harder than you needed to. It bursts easily, leaving scarcely a trace behind.

Soon enough your work is complete. The ring is gone.

It's just you and the silence, now.

>look behind log
Nothing else lurks there.

* * *

>look behind log
Tightening your grip on the stake, you peer behind the log, so that you can see the whole of the mushroom ring, and whatever else might sit inside it.

You see it. A skinny little man, wearing a... a fur coat, and a spotted cap? It's lying down, right in the center of the fairy ring, damn it all, and its tail twitches as it... oh.

You let go the breath you hadn't realized you were holding. No, it's not a little man. Though it is another sort of forest creature, true enough, and maybe no less wicked, in its way.

And that "cap" does catch your attention...

>kill ring
Grunting, you kick one of the mushrooms, maybe a little harder than you needed to. It bursts easily, leaving scarcely a trace behind.

That gets the little animal's attention. In a flash, it vanishes into the wood, leaving its meal behind.

Soon enough your work is complete. The ring is gone.

It's just you and the silence, now.

>l
Behind your cottage
Another small clearing behind your cottage. You do not come here very often, or anyway not lately.

You could wander back into the reeds to the south, or return to your garden by walking northwest or southwest around your home. The road lies to the north, where it runs east, vanishing into the dark wood.

The forest also looms to the east of where you now stand. An old fallen log reaches out of it, into the clearing.

Two standing stones mark the earth here, along the rear wall of the cottage. One, waist-high, stands larger than the other.

A bird's egg, emptied out, lies on the ground here.

* * *

>look behind log
Tightening your grip on the stake, you peer behind the log, so that you can see the whole of the mushroom ring, and whatever else might sit inside it.

You see it. A skinny little man, wearing a... a fur coat, and a spotted cap? It's lying down, right in the center of the fairy ring, damn it all, and its tail twitches as it... oh.

You let go the breath you hadn't realized you were holding. No, it's not a little man. Though it is another sort of forest creature, true enough, and maybe no less wicked, in its way.

And that "cap" does catch your attention...

>kill stoat
The little animal isn't so absorbed in its meal that it doesn't hear you approach. It pulls its head from the egg to regard you just as you start to raise your club. Then, quick as a flash, it's gone, swallowed up by the forest.

It has left its egg behind.

>drop stake
Dropped.

>nw
Outside the cottage
A space in front of your home, long ago cleared from the reed bank to the south. You can see the road from here, and of course the forest beyond it.

Your garden lies here, good earth and green, a row of stones marking it off.

The doorway to your cottage is to the east. You could also walk around the cottage, to the northeast or the southeast, towards the little clearing you know is there.

Silence, especially strange for this time of day, sits heavily in the clearing.

>ne
Behind your cottage
Another small clearing behind your cottage. You do not come here very often, or anyway not lately.

You could wander back into the reeds to the south, or return to your garden by walking northwest or southwest around your home. The road lies to the north, where it runs east, vanishing into the dark wood.

The forest also looms to the east of where you now stand. An old fallen log reaches out of it, into the clearing.

Two standing stones mark the earth here, along the rear wall of the cottage. One, waist-high, stands larger than the other.

A bird's egg, emptied out, lies on the ground here.

You can also see a stake here.

* * *

>x green
The bird dropped down into the reeds some distance away, near one particularly tall stalk, topped with a flower that's come in early.

>x flower
(the tall stalk)
Carefully approaching the tall stalk, you discover the hiding place of the reed bird's nest.

The reed-bird goes about the business of feeding its young.

* * *

>get egg
Holding it, you now see that the egg's surface is webbed with cracks, as if it had been dropped.

>i
You are carrying:
  a small cracked egg (closed)

>x feathers
Collected under the nest is a small pile of bird-leavings.

>i
You are carrying:
  a small cracked egg (closed)

* * *

>z
Time passes.

The chick, now fed, resettles itself atop the nest, preening a bit. As it does so, loose feathers and other bits of refuse drift down to join a pile on the ground beneath it.

>search mound
Collected under the nest is a small pile of bird-leavings.

You spy a small egg lying among the offal.

>get egg
Holding it, you now see that the egg's surface is webbed with cracks, as if it had been dropped.

* * *

>z
Time passes.

The chick, now fed, resettles itself atop the nest, preening a bit. As it does so, loose feathers and other bits of refuse drift down to join a pile on the ground beneath it.

>x nest
A basket-shaped nest of loosely woven brown grasses. It stands out among the bright green summer reeds, but they grow so thick that it remains well concealed regardless. It's just high enough off the damp ground to keep it safe from most of the crawling animals.

Squatting atop the nest is a single, large chick.

>l
Among the reeds
The familiar reed bank behind your cottage surrounds you, filling the damp space between your home and the river to the south.

Under the nest is a small mound of feathers, straw, droppings, and other matter apparently dropped from the reed-bird's nest and its occupant.

One particularly tall stalk, topped with an early flower, marks the location of the reed bird's nest.

>x mound
Collected under the nest is a small pile of bird-leavings.

You spy a small egg lying among the offal.

>search mound
Collected under the nest is a small pile of bird-leavings.

You spy a small egg lying among the offal.

>get mound
You pluck the egg from the mound of bird-leavings.

Holding it, you now see that the egg's surface is webbed with cracks, as if it had been dropped.

>i
You are carrying:
  a small cracked egg (closed)

* * *

>x nest
A basket-shaped nest of loosely woven brown grasses. It stands out among the bright green summer reeds, but they grow so thick that it remains well concealed regardless. It's just high enough off the damp ground to keep it safe from most of the crawling animals.

Squatting atop the nest is a single, large chick.

>x chick
This bird has the plumage and shape of one that's hatched very recently. Oddly, though, it looks like a larger animal than you remember its parent being. It's so large that it doesn't seem to quite fit in the nest, instead squatting on top of it.

>touch chick
You'd rather not disturb this nest. You've been living fine all these years considering the reed-bird a thatcher's friend, keeping the reeds free of worse nuisances.

>touch nest
You'd rather not disturb this nest. You've been living fine all these years considering the reed-bird a thatcher's friend, keeping the reeds free of worse nuisances.

>smell nest
You'd rather not disturb this nest. You've been living fine all these years considering the reed-bird a thatcher's friend, keeping the reeds free of worse nuisances.

>search chick
You'd rather not disturb this nest. You've been living fine all these years considering the reed-bird a thatcher's friend, keeping the reeds free of worse nuisances.

>search nest
No eggs here. That big chick would leave them no room, anyway.

>look under nest
Collected under the nest is a small pile of bird-leavings.

You spy a small egg lying among the offal.

* * *

>s
Beach
A small bulge of sandy beach, providing a place to stand comfortably and access the river water clear of the reeds. The river to the south curves gently around it.

The river flows here, as it always has, clear and cool.

>n
Among the reeds
The familiar reed bank behind your cottage surrounds you, filling the damp space between your home and the river to the south.

One particularly tall stalk, topped with an early flower, marks the place where that reed-bird flew.

>s
Beach
A small bulge of sandy beach, providing a place to stand comfortably and access the river water clear of the reeds. The river to the south curves gently around it.

The river flows here, as it always has, clear and cool.

* * *

>n
Among the reeds
The familiar reed bank behind your cottage surrounds you, filling the damp space between your home and the river to the south.

One particularly tall stalk, topped with an early flower, marks the place where that reed-bird flew.

>x flitting shadow
The bird dropped down into the reeds some distance away, near one particularly tall stalk, topped with a flower that's come in early.

>g
The bird dropped down into the reeds some distance away, near one particularly tall stalk, topped with a flower that's come in early.

>x flower
(the tall stalk)
Carefully approaching the tall stalk, you discover the hiding place of the reed bird's nest.

The reed-bird goes about the business of feeding its young.

>x flitting shadow
You can't see any such thing.

>x bird
(the reed-bird)
A small reddish bird. It's perched on a stem beside its nest, feeding its young.

The reed-bird goes about the business of feeding its young.

* * *

>search reeds
"Eggshells," he said. "You should find two, empty but mostly whole."

"Well," you said, "That's easy enough. Hod down the road has a hen, and --"

"No," he interrupted with a shake of his grey head. "You've got to find them in the wild places in between, where nobody lives. Not even them. Go out in the hour just before sundown, when they're not quite awake yet..."

Remembering, you look at the sky, reflexively.

Today the sky is a uniform middling gray. Overcast.

You part the reeds nearest you and peer at the marshy ground underneath them, but find nothing useful.

>g
You part the reeds nearest you and peer at the marshy ground underneath them, but find nothing useful.

>n
As you start back towards your home, movement among the reeds catches your eye: A little reed-bird flies in from the riverbank and vanishes into the green, near a tall stalk with an early flower.

>n
Outside the cottage
A space in front of your home, long ago cleared from the reed bank to the south. You can see the road from here, and of course the forest beyond it.

Your garden lies here, good earth and green, a row of stones marking it off.

The doorway to your cottage is to the east. You could also walk around the cottage, to the northeast or the southeast, towards the little clearing you know is there.

Something is wrong.

* * *

>swim
No place to do that, here.

>s
Beach
A small bulge of sandy beach, providing a place to stand comfortably and access the river water clear of the reeds. The river to the south curves gently around it.

The river flows here, as it always has, clear and cool.

>swim
You saw to your washing and all that before you began. Best focus on your task.

>swim in water
You saw to your washing and all that before you began. Best focus on your task.

* * *

>x ground
"Eggshells," he said. "You should find two, empty but mostly whole."

"Well," you said, "That's easy enough. Hod down the road has a hen, and --"

"No," he interrupted with a shake of his grey head. "You've got to find them in the wild places in between, where nobody lives. Not even them. Go out in the hour just before sundown, when they're not quite awake yet..."

Remembering, you look at the sky, reflexively.

Today the sky is a uniform middling gray. Overcast.

You part the reeds nearest you and peer at the marshy ground underneath them, but find nothing useful.

>s
Beach
A small bulge of sandy beach, providing a place to stand comfortably and access the river water clear of the reeds. The river to the south curves gently around it.

The river flows here, as it always has, clear and cool.

>x ground
Only the ground.

>n
Among the reeds
The familiar reed bank behind your cottage surrounds you, filling the damp space between your home and the river to the south.

>n
As you start back towards your home, movement among the reeds catches your eye: A little reed-bird flies in from the riverbank and vanishes into the green, near a tall stalk with an early flower.

* * *

>n
Outside the cottage
A space in front of your home, long ago cleared from the reed bank to the south. You can see the road from here, and of course the forest beyond it.

Your garden lies here, good earth and green, a row of stones marking it off.

The doorway to your cottage is to the east. You could also walk around the cottage, to the northeast or the southeast, towards the little clearing you know is there.

Something is wrong.

>x ground
Only the ground.

You realize what's wrong now. It's quiet.

You were so involved among the reeds just now that you hadn't paid it mind, but: the cottage is silent.

>x d
Only the ground.

>x u
Today the sky is a uniform middling gray. Overcast.

>d
Nothing that way...

Your cottage's doorway lies to the east, and the reed banks whisper to the south. There's also that clearing behind your cottage.

>s
Among the reeds
The familiar reed bank behind your cottage surrounds you, filling the damp space between your home and the river to the south.

One particularly tall stalk, topped with an early flower, marks the place where that reed-bird flew.

>s
Beach
A small bulge of sandy beach, providing a place to stand comfortably and access the river water clear of the reeds. The river to the south curves gently around it.

The river flows here, as it always has, clear and cool.

>d
The only place to go from here is north, into the reeds and back towards your cottage.

>n
Among the reeds
The familiar reed bank behind your cottage surrounds you, filling the damp space between your home and the river to the south.

One particularly tall stalk, topped with an early flower, marks the place where that reed-bird flew.

>x flower
(the tall stalk)
Carefully approaching the tall stalk, you discover the hiding place of the reed bird's nest.

The reed-bird goes about the business of feeding its young.

>x bird
(the reed-bird)
A small reddish bird. It's perched on a stem beside its nest, feeding its young.

The reed-bird goes about the business of feeding its young.

>z
Time passes.

The reed-bird goes about the business of feeding its young.

The reed-bird darts away again, perhaps looking for more food for its enormous chick.

* * *

>z
Time passes.

The chick, now fed, resettles itself atop the nest, preening a bit. As it does so, loose feathers and other bits of refuse drift down to join a pile on the ground beneath it.

>x ground
Careful not to disturb the nest, you poke through the ground around it. Your efforts are rewarded: Not far away, among a small pile of the birdish refuse on the ground, lies a small egg.

>x ground
You part the reeds nearest you and peer at the marshy ground underneath them, but find nothing useful.

>l
Among the reeds
The familiar reed bank behind your cottage surrounds you, filling the damp space between your home and the river to the south.

A small, spotted egg lies on the ground underneath the nest.

Under the nest is a small mound of feathers, straw, droppings, and other matter apparently dropped from the reed-bird's nest and its occupant.

One particularly tall stalk, topped with an early flower, marks the location of the reed bird's nest.

>restart
Are you sure you want to restart?